# 5 lignes, 7 colonnes
5;7
. . . X . . .
. X . . . X .
. . B . . . .
. . . . X . T
P . . . . . .